(   )+0=0
0+(   )=0
(   )-0=0
0-(   )=0
(   )+1=1
0+(   )=1
(   )+2=2
0+(   )=2
(   )+3=3
0+(   )=3
(   )+4=4
0+(   )=4
(   )+5=5
0+(   )=5
(   )+6=6
0+(   )=6
(   )+7=7
0+(   )=7
(   )+8=8
0+(   )=8
(   )+9=9
0+(   )=9
(   )+10=10
0+(   )=10
(   )+0=1
1+(   )=1
(   )-0=1
1-(   )=1
(   )+1=2
1+(   )=2
(   )-1=0
1-(   )=0
(   )+2=3
1+(   )=3
(   )+3=4
1+(   )=4
(   )+4=5
1+(   )=5
(   )+5=6
1+(   )=6
(   )+6=7
1+(   )=7
(   )+7=8
1+(   )=8
(   )+8=9
1+(   )=9
(   )+9=10
1+(   )=10
(   )+0=2
2+(   )=2
(   )-0=2
2-(   )=2
(   )+1=3
2+(   )=3
(   )-1=1
2-(   )=1
(   )+2=4
2+(   )=4
(   )-2=0
2-(   )=0
(   )+3=5
2+(   )=5
(   )+4=6
2+(   )=6
(   )+5=7
2+(   )=7
(   )+6=8
2+(   )=8
(   )+7=9
2+(   )=9
(   )+8=10
2+(   )=10
(   )+0=3
3+(   )=3
(   )-0=3
3-(   )=3
(   )+1=4
3+(   )=4
(   )-1=2
3-(   )=2
(   )+2=5
3+(   )=5
(   )-2=1
3-(   )=1
(   )+3=6
3+(   )=6
(   )-3=0
3-(   )=0
(   )+4=7
3+(   )=7
(   )+5=8
3+(   )=8
(   )+6=9
3+(   )=9
(   )+7=10
3+(   )=10
(   )+0=4
4+(   )=4
(   )-0=4
4-(   )=4
(   )+1=5
4+(   )=5
(   )-1=3
4-(   )=3
(   )+2=6
4+(   )=6
(   )-2=2
4-(   )=2
(   )+3=7
4+(   )=7
(   )-3=1
4-(   )=1
(   )+4=8
4+(   )=8
(   )-4=0
4-(   )=0
(   )+5=9
4+(   )=9
(   )+6=10
4+(   )=10
(   )+0=5
5+(   )=5
(   )-0=5
5-(   )=5
(   )+1=6
5+(   )=6
(   )-1=4
5-(   )=4
(   )+2=7
5+(   )=7
(   )-2=3
5-(   )=3
(   )+3=8
5+(   )=8
(   )-3=2
5-(   )=2
(   )+4=9
5+(   )=9
(   )-4=1
5-(   )=1
(   )+5=10
5+(   )=10
(   )-5=0
5-(   )=0
(   )+0=6
6+(   )=6
(   )-0=6
6-(   )=6
(   )+1=7
6+(   )=7
(   )-1=5
6-(   )=5
(   )+2=8
6+(   )=8
(   )-2=4
6-(   )=4
(   )+3=9
6+(   )=9
(   )-3=3
6-(   )=3
(   )+4=10
6+(   )=10
(   )-4=2
6-(   )=2
(   )-5=1
6-(   )=1
(   )-6=0
6-(   )=0
(   )+0=7
7+(   )=7
(   )-0=7
7-(   )=7
(   )+1=8
7+(   )=8
(   )-1=6
7-(   )=6
(   )+2=9
7+(   )=9
(   )-2=5
7-(   )=5
(   )+3=10
7+(   )=10
(   )-3=4
7-(   )=4
(   )-4=3
7-(   )=3
(   )-5=2
7-(   )=2
(   )-6=1
7-(   )=1
(   )-7=0
7-(   )=0
(   )+0=8
8+(   )=8
(   )-0=8
8-(   )=8
(   )+1=9
8+(   )=9
(   )-1=7
8-(   )=7
(   )+2=10
8+(   )=10
(   )-2=6
8-(   )=6
(   )-3=5
8-(   )=5
(   )-4=4
8-(   )=4
(   )-5=3
8-(   )=3
(   )-6=2
8-(   )=2
(   )-7=1
8-(   )=1
(   )-8=0
8-(   )=0
(   )+0=9
9+(   )=9
(   )-0=9
9-(   )=9
(   )+1=10
9+(   )=10
(   )-1=8
9-(   )=8
(   )-2=7
9-(   )=7
(   )-3=6
9-(   )=6
(   )-4=5
9-(   )=5
(   )-5=4
9-(   )=4
(   )-6=3
9-(   )=3
(   )-7=2
9-(   )=2
(   )-8=1
9-(   )=1
(   )-9=0
9-(   )=0
(   )+0=10
10+(   )=10
(   )-0=10
10-(   )=10
(   )-1=9
10-(   )=9
(   )-2=8
10-(   )=8
(   )-3=7
10-(   )=7
(   )-4=6
10-(   )=6
(   )-5=5
10-(   )=5
(   )-6=4
10-(   )=4
(   )-7=3
10-(   )=3
(   )-8=2
10-(   )=2
(   )-9=1
10-(   )=1
(   )-10=0
10-(   )=0